die Leute -  люди

der Mensch - человек (мн.: Menschen)
der Mann - мужчина; муж
die Frau - женщина; жена
das Kind  - ребенок
der Junge - мальчик
das Mädchen - девочка
der Freund - друг
der Bekannte - знакомый
der Nachbar - сосед
der Gast  - гость
der Chef  - начальник; шеф
der Konkurrent - конкурент
der Kunde - клиент, покупатель
der Kollege - коллега

die Familie - семья
die Eltern  - родители
der Vater - отец
der Vati - папа
die Mutter - мать
die Mutti - мама
der Sohn - сын
die Tochter - дочь
der Bruder - брат
die Schwester - сестра
der Großvater - дед
der Opa - дедушка
die Großmutter - бабушка
die Oma - бабуля
der Enkel - внук
die Enkelin - внучка
der Schwiegervater - тесть, свекор
die Schwiegermutter - тёща, свекровь
der Onkel - дядя
die Tante - тетя
der Cousin [кузэн] - двоюродный брат
die Kusine - двоюродная сестра
der Neffe - племянник
die Nichte - племянница

dieser - этот 
jener - тот
zusammen - вместе

vorstellen - представлять, знакомить 
kennenlernen - узнавать, знакомиться
kennen - знать, быть знакомым
treffen - встретиться
verbringen - проводить (время)
bleiben - оставаться
verlassen - покидать
