das Gefühl - чувство

der Spaß - веселье
die Freude - радость
die Angst - страх
die Traurigkeit - печаль
die Leidenschaft - страсть, страстность
das Vergnügen - удовольствие
das Glück - счастье
die Schönheit - красота
der Frieden - мир (покой)

fühlen - чувствовать
lieben  - любить
gefallen - нравиться
hassen - ненавидеть
wünschen - желать
träumen - мечтать; видеть сон
sehen - видеть
hören - слышать, слушать
stinken - вонять
riechen - пахнуть; нюхать
befürchten - бояться, опасаться
interessieren, sich - интересоваться
überraschen - удивлять
genießen - наслаждаться; пользоваться
lächeln - улыбаться
lachen - смеяться
weinen - плакать
sorgen, sich - беспокоиться

wunderbar - замечательный
gut - хороший; добрый
ausgezeichnet - отличный
erstaunlich - удивительный
wunderschön  - прекрасный, чудесный
schlecht - плохой
schrecklich - ужасный
satt - сытый
hungrig - голодный
böse - сердитый, злой
lustig - веселый
froh - радостный
glücklich - счастливый
traurig - печальный
lieb - дорогой, милый
zart - нежный
mutig - смелый
feige - трусливый
müde - усталый
frei - свободный
beschäftigt - занятый

besser - лучше; более хороший
best  - лучший
mehr  - больше (по количеству); более
meist - наибольший (по количеству)
lieber - лучше, охотней
am liebsten - охотней всего
