die Zeit - время

die Uhr - часы
die Minute - минута
die Stunde - час
die Woche - неделя
das Jahr - год
das Jahrhundert - век, столетие 
das Mal - раз



der Tag - день

der Morgen - утро 
der Vormittag - время до полудня
der Nachmittag - время после полудня
der Abend - вечер
die Nacht - ночь
vorgestern - позавчера
gestern - вчера
heute - сегодня
jetzt - сейчас
dann - потом
morgen - завтра
übermorgen - послезавтра
der Montag  - понедельник
der Dienstag - вторник
der Mittwoch - среда
der Donnerstag - четверг
der Freitag - пятница
der Samstag - суббота
der Sonntag - воскресенье



der Monat - месяц

der Januar - январь
der Februar - февраль
der März - март
der April - апрель
der Mai - май
der Juni - июнь
der Juli - июль
der August - август
der September - сентябрь
der Oktober - октябрь
der November - ноябрь
der Dezember - декабрь



die Jahreszeit - время года

der Frühling - весна
der Sommer - лето
der Herbst - осень
der Winter - зима
