die Natur - природа

der Wald - лес
der Fluss - река
der Berg - гора
der See - озеро
das Meer - море
der Ozean - океан
die Küste - морской берег, побережье
der Strand - пляж
der Sand - песок
die Insel - остров
der Stein - камень
der Grund - причина; грунт, земля
das Feuer - огонь



das Wetter - погода

die Sonne - солнце
der Mond - луна
der Wind - ветер
der Nebel - туман
der Regen - дождь
der Schnee - снег
der Himmel - небо
die Wolke - облако
die Luft - воздух
die Temperatur - температура
der Grad - градус

heiß - жаркий; горячий
warm - тёплый
kalt - холодный
kühl - прохладный



die Pflanze - растение

der Baum - дерево
das Gras - трава
die Blume - цветок
das Blatt - лист
die Palme - пальма


das Tier - животное

der Bär - медведь
der Wolf - волк
der Fuchs - лиса
der Hase - заяц
der Elefant - слон
der Vogel - птица
der Schwan - лебедьs
der Affe - обезьяна
der Frosch - лягушка
der Hund - собака
die Katze - кошка
die Maus - мышь
die Ratte - крыса
die Gans - гусь
die Eule - сова
die Giraffe - жираф
die Kuh - корова
die Ente - утка
das Kaninchen - кролик
das Pferd - лошадь
das Eichhörnchen - белка
das Schwein - свинья
