die Gesundheit - здоровье

gesund - здоровый
krank - больной
die Krankheit - болезнь
das Fieber  - жар, (высокая) температура
der Husten - кашель
der Schnupfen - насморк
niesen - чихать
der Schmerz - боль
die Kopfschmerzen - головная боль
weh tun - болеть
die Grippe - грипп 
die Erkältung - простуда
die Prellung - синяк, ушиб

rauchen - курить



der Körper - тело

der Kopf - голова
das Gesicht - лицо
die Stirn - лоб
die Nase - нос
das Ohr - ухо
der Mund - рот
der Hals - горло; шея
das Auge - глаз
die Augenbraue  - бровь
die Lippen - губы
der Zahn - зуб
das Haar - волос(ы)
der Schnurrbart - усы 
der Bart - борода
die Wange - щека
das Kinn - подбородок
die Schulter - плечо
die Brust - грудь
das Herz - сердце
der Bauch - живот
der Rücken - спина
das Handgelenk - запястье
die Hand - рука, кисть (руки) 
der Arm - рука (вся) 
der Finger - палец (руки)
der Nagel - ноготь; гвоздь
der Ellenbogen - локоть
das Bein - нога
das Knie - колено
der Fuß - нога, ступня; подножие
die Ferse - пятка
die Zehe - палец (ноги)
der Knochen - кость
