die Sache - вещь

die Bürste - щетка
die Seife - мыло
das Handtuch - полотенце
das Bügeleisen - утюг
das Laken - простыня
das Kissen - подушка
die Vase - ваза
der Eimer - ведро



der Hammer - молоток

der Schlüssel - ключ
die Schere - ножницы
die Schaufel - лопата
der Stock - палка
der Klebstoff - клей
die Leine - веревка 
der Draht - проволока
das Brett - доска, брусок
das Kabel - провод, кабель
die Lampe - лампа
die Taschenlampe - карманный фонарь
der Kasten - ящик
die Kiste - коробка



der Fernseher - телевизор

der Laptop [лэптоп] - ноутбук 
die Tastatur - клавиатура 
die Taste - клавиша
das Radio - радио
die Kamera - камера
der Fotoapparat - фотоаппарат
die Akku, Batterie - батарейка, аккумулятор
das Telefon - телефон
das Handy [хэнди] - сотовый телефон



fernsehen - смотреть телевизор
waschen - мыть, cтирать
rasieren, sich - бриться
kochen - варить; готовить
backen - печь
schneiden  - резать
brechen - ломать
reparieren - чинить
abbiegen - повернуть
ziehen - тянуть; перемещаться
