die Arbeit - работа

der Geschäftsmann - бизнесмен
der Lehrer - учитель
der Fahrer  - водитель
der Arbeiter  - рабочий
der Ingenieur - инженер
der Arzt - врач
der Rechtsanwalt - адвокат
der Journalist - журналист
die Krankenschwester  - медсестра
der Verkäufer - продавец
der Kellner - официант
der Buchhalter - бухгалтер
der Maler - художник
der Musiker - музыкант
der Schauspieler - актер
der Student - студент
der Schüler - школьник, ученик
die Einladung - приглашение
die Entwicklung - развитие
die Anstrengung - усилие
der Erfolg - успех
die Gefahr - опасность
der Fall - случай; дело; падение
der Umstand - обстоятельство
die Verzögerung - задержка, промедление
der Bereich - область, сфера
die Leistung - достижение, успех
der Vertrag - договор
die Pflicht - обязанность
der Streit - спор
die Vereinbarung - соглашение; согласие
die Erlaubnis - разрешение
der Rat - совет
die Entscheidung - решение, принятие решения
die Lösung - решение (проблемы)

erhalten - получать (офиц.)
stören - беспокоить, мешать 
entscheiden - решать, принимать решение
lösen - решать (проблему); растворять
befehlen - приказывать
bauen - строить


