der Schule

die Wissenschaft - наука
das Wissen - знание
das Benehmen - поведение
die Aufgabe - задача, задание
die Übung - упражнение
das Problem - проблема
die Gelegenheit - (благоприятная) возможность
die Fähigkeit - способность
die Note - оценка, отметка, знак; нота
der Fehler - ошибка
die Ordnung - порядок
die Tafel - доска (школьная), плитка (шоколада)
die Liste - список
der Test  - тест, испытание
die Prüfung - экзамен

dumm - глупый
klug - умный
schwierig - трудный, тяжелый
einfach - простой
scheu - застенчивый
fleißig - прилежный
faul - ленивый
falsch - неправильный
stark - сильный; крепкий
schwach - слабый
laut - громкий, шумный 
leise - тихий, негромкий
ruhig - тихий, спокойный
eng  - узкий
breit - широкий
sauber - чистый
schmutzig - грязный
bequem - уютный
seltsam - странный
bereit - готовый (что-то сделать)
fertig - готовый (завершенный)
aufmerksam - внимательный
vorsichtig - осторожный
fähig - способный
wichtig - важный
sicher - уверенный 
echt - настоящий, истинный; "правда?"

lehren - учить, обучать
lernen - учить(ся)
studieren - учиться (в вузе); изучать
besuchen - посещать
prüfen  - проверять
bestrafen - наказывать
klagen - жаловаться
denken - думать
lesen - читать
wissen - знать 
sagen - сказать
erklären - объяснять
zeigen - показывать
erinnern - напоминать
lassen - позволять; оставлять
