machen - делать (что-то)

bekommen - получать
werden - становиться (передаёт: буд. вр., страд. залог)
tun - делать (вообще)
haben - иметь
haben zu - должен (что-то сделать)
sein zu - должен (быть сделанным)
finden - находить
halten - держать; останавливаться
gewinnen - побеждать, выигрывать
kommen - приходить, приезжать
nehmen - брать
geben - давать
schenken - дарить
entschuldigen - прощать
essen - кушать
trinken - пить
führen - вести
klingen - звенеть
rufen - звать; кричать
anrufen - звонить
sprechen - разговаривать, говорить
verstehen - понимать
liegen - лежать
legen - класть
stehen - стоять
sitzen - сидеть
setzen, sich - садиться
bringen - приносить, привозить
zurückgeben - возвращать
zurückkehren - возвращаться
leben - жить 
wohnen - проживать
arbeiten - работать
beginnen - начинать
ändern - (из)менять
öffnen - открывать
schließen  - закрывать
vorhaben - намереваться
vergessen - забывать
erinnern, sich - вспоминать
fragen - спрашивать
bitten - просить 
bieten - предлагать
antworten - отвечать
warten - ждать
erwarten - ожидать
glauben - верить, полагать
stimmen - быть правильным, верным
zustimmen - соглашаться 
streiten - спорить 
zählen - считать
scherzen - шутить
passen - соответствовать, подходить
beeinflussen - влиять
unterstützen - поддерживать
überzeugen - убеждать
genehmigen - позволять, санкционировать, одобрять
schätzen - ценить
