kaufen - покупать

die Einkäufe - покупки
die Größe - размер
der Preis - цена
die Wahl - выбор 
das Geld - деньги
das Bargeld  - наличные (деньги)
der Rabatt - скидка
das Konto - счет (банковский)
die Rechnung - счёт (для оплаты)
das Trinkgeld - чаевые
die Lieferung  - доставка; поставка

genug - достаточно

kostenlos - бесплатный
billig - дешёвый 
teuer - дорогой (о цене) 
notwendig - необходимый
nützlich - полезный
nutzlos - бесполезный
arm - бедный
reich - богатый
ehrlich - честный

brauchen - нуждаться
kosten - стоить
bestellen - заказывать
bezahlen - оплачивать
senden - посылать
leihen - одолжить
speichern - сохранять, накапливать
sparen - экономить, копить

